4,6,4,2,2,-1,0,1,2,2
4,-1,2,4,3,2,0,3,6,5
3,0,-1,4,2,3,2,-1,4,4
2,1,4,4,6,4,2,2,3,5
2,2,3,5,2,3,3,2,3,1
3,1,2,3,2,-1,2,2,0,4
2,0,2,-1,3,1,1,1,1,-1
0,1,1,3,-1,2,0,3,2,3
2,3,2,1,1,0,2,3,1,5
4,3,2,2,-1,1,1,2,4,3